* change buffers:                        Select Buffer.      (line    6)
* change Emacs directory:                Initial Options.    (line   20)
* change log:                            Change Log.         (line    6)
* Change Log mode:                       Change Log Commands.
                                                             (line   40)
* changes, undoing:                      Undo.               (line    6)
* changeset-based version control:       VCS Changesets.     (line   14)
* changing file group (in Dired):        Operating on Files. (line  101)
* changing file owner (in Dired):        Operating on Files. (line  105)
* changing file permissions (in Dired):  Operating on Files. (line   96)
* changing file time (in Dired):         Operating on Files. (line  114)
* char mode (terminal emulator):         Terminal emulator.  (line   10)
* character equivalence in search:       Lax Search.         (line    6)
* character folding in replace commands: Replacement and Lax Matches.
                                                             (line   48)
* character folding in search:           Lax Search.         (line   77)
* character set (keyboard):              User Input.         (line    6)
* character set of character at point:   International Chars.
                                                             (line   65)
* character syntax:                      Init Syntax.        (line   52)
* characters (in text):                  Text Display.       (line    6)
* characters in a certain charset:       Charsets.           (line   24)
* characters which belong to a specific language: Regexp Backslash.
                                                             (line  143)
* characters with no font glyphs:        Text Display.       (line   52)
* characters, inserting by name or code-point: Inserting Text.
                                                             (line   60)
* charsets:                              Charsets.           (line    6)
* checking out files:                    VCS Concepts.       (line   13)
* checking spelling:                     Spelling.           (line    6)
* checking syntax:                       Flymake.            (line    6)
* checklist before reporting a bug:      Checklist.          (line    6)
* Chinese:                               Language Environments.
                                                             (line   29)
* Chinese calendar:                      Calendar Systems.   (line   58)
* choosing a major mode:                 Choosing Modes.     (line    6)
* choosing a minor mode:                 Choosing Modes.     (line    6)
* ciphers:                               Amusements.         (line   19)
* citing mail:                           Citing Mail.        (line    6)
* CKJ characters:                        Modifying Fontsets. (line   50)
* class browser, C++:                    Tags Tables.        (line   26)
* Cleartype:                             Windows Fonts.      (line  107)
* click events:                          Mouse Buttons.      (line    6)
* client frame:                          emacsclient Options.
                                                             (line   32)
* client-side fonts:                     Fonts.              (line  197)
* clipboard:                             Clipboard.          (line    6)
* clipboard manager:                     Clipboard.          (line   33)
* clocking time:                         Time Intervals.     (line    6)
* close buffer:                          Kill Buffer.        (line    6)
* close file:                            Kill Buffer.        (line    6)
* codepage, MS-DOS:                      MS-DOS and MULE.    (line   21)
* codepoint of a character:              Modifying Fontsets. (line   39)
* coding standards:                      Coding Standards.   (line    6)
* coding systems:                        Coding Systems.     (line    6)
* collision:                             Interlocking.       (line   30)
* color emulation on black-and-white printers: PostScript Variables.
                                                             (line   17)
* color name:                            Colors.             (line   14)
* color of window, from command line:    Colors X.           (line    6)
* color scheme:                          Custom Themes.      (line   16)
* Column Number mode:                    Optional Mode Line. (line   23)
* columns (and rectangles):              Rectangles.         (line    6)
* columns (indentation):                 Indentation.        (line    6)
* columns, splitting:                    Two-Column.         (line    6)
* Comint mode:                           Shell Mode.         (line  147)
* comint-highlight-input face:           Interactive Shell.  (line   24)
* comint-highlight-prompt face:          Interactive Shell.  (line   24)
* command:                               Commands.           (line    6)
* command history:                       Repetition.         (line    6)
* command line arguments:                Emacs Invocation.   (line    6)
* commands in xref buffers:            Xref Commands.      (line    6)
* comments:                              Comments.           (line    6)
* comments on customized settings:       Changing a Variable.
                                                             (line  120)
* Common Lisp:                           External Lisp.      (line    6)
* compare files (in Dired):              Comparison in Dired.
                                                             (line    6)
* comparing 3 files (diff3):             Comparing Files.    (line   54)
* comparing files:                       Comparing Files.    (line    6)
* compilation buffer, keeping point at end: Compilation.     (line   58)
* compilation errors:                    Compilation.        (line    6)
* Compilation mode:                      Compilation Mode.   (line    6)
* compilation mode faces:                Compilation Mode.   (line   13)
* compilation under MS-DOS:              MS-DOS Processes.   (line    6)
* complete key:                          Keys.               (line   10)
* completion:                            Completion.         (line    6)
* completion (Lisp symbols):             Symbol Completion.  (line   14)
* completion (symbol names):             Symbol Completion.  (line    6)
* completion alternative:                Completion.         (line   10)
* completion list:                       Completion Commands.
                                                             (line   35)
* completion style:                      Completion Styles.  (line    6)
* compose character:                     Unibyte Mode.       (line   63)
* compressing files (in Dired):          Operating on Files. (line  126)
* compression:                           Compressed Files.   (line    6)
* Conf mode:                             Program Modes.      (line   15)
* confirming in the minibuffer:          Completion Exit.    (line   34)
* conflicts:                             Merging.            (line   34)
* connecting to remote host:             Remote Host.        (line    6)
* connection-local variables:            Connection Variables.
                                                             (line    6)
* contents of a buffer:                  Buffers.            (line   34)
* continuation line:                     Continuation Lines. (line    6)
* contributing to Emacs:                 Contributing.       (line    6)
* Control:                               User Input.         (line   18)
* control character:                     User Input.         (line   11)
* control characters on display:         Text Display.       (line   11)
* converting text to upper or lower case: Case.              (line   20)
* Coptic calendar:                       Calendar Systems.   (line   41)
* copy:                                  Cut and Paste.      (line    6)
* copy/paste to/from primary selection (macOS): Mac / GNUstep Basics.
                                                             (line   24)
* copying files:                         Copying and Naming. (line   22)
* copying files (in Dired):              Operating on Files. (line   40)
* copying text:                          Yanking.            (line    6)
* copyright assignment:                  Copyright Assignment.
                                                             (line    6)
* CORBA IDL mode:                        C Modes.            (line    6)
* core dump:                             Crashing.           (line   50)
* correcting spelling:                   Spelling.           (line    6)
* CPerl mode:                            Program Modes.      (line   15)
* crash report:                          Crashing.           (line    6)
* crashes:                               Auto Save.          (line    6)
* create a text-based table:             Table Creation.     (line    6)
* creating files:                        Visiting.           (line   45)
* creating frames:                       Creating Frames.    (line    6)
* Croatian:                              Language Environments.
                                                             (line   30)
* cryptanalysis:                         Amusements.         (line   19)
* CSSC:                                  Version Control Systems.
                                                             (line   16)
* CUA key bindings:                      CUA Bindings.       (line    6)
* curly quotes:                          Quotation Marks.    (line    6)
* curly quotes, and terminal capabilities: Text Display.     (line   63)
* curly quotes, inserting:               Inserting Text.     (line   60)
* current buffer:                        Buffers.            (line   27)
* current function name in mode line:    Which Function.     (line    6)
* current message (Rmail):               Rmail Basics.       (line   13)
* current project:                       Projects.           (line   25)
* cursor:                                Point.              (line    6)
* cursor color, command-line argument:   Colors X.           (line   24)
* cursor face:                           Faces.              (line   39)
* cursor in non-selected windows:        Cursor Display.     (line   48)
* cursor location:                       Position Info.      (line   37)
* cursor location, on MS-DOS:            Text and Binary.    (line   20)
* cursor motion:                         Moving Point.       (line    6)
* cursor shape on MS-DOS:                MS-DOS Display.     (line   19)
* cursor, blinking:                      Cursor Display.     (line   24)
* cursor, visual-order motion:           Bidirectional Editing.
                                                             (line   93)
* curved quotes:                         Quotation Marks.    (line    6)
* curved quotes, and terminal capabilities: Text Display.    (line   63)
* curved quotes, inserting:              Inserting Text.     (line   60)
* custom themes:                         Custom Themes.      (line    6)
* custom themes, creating:               Creating Custom Themes.
                                                             (line    6)
* customizable variable:                 Easy Customization. (line    6)
* customization:                         Customization.      (line    6)
* customization buffer:                  Easy Customization. (line   14)
* customization groups:                  Customization Groups.
                                                             (line    6)
* customization of menu face:            Standard Faces.     (line  149)
* customizing faces:                     Face Customization. (line    6)
* customizing Lisp indentation:          Lisp Indent.        (line    6)
* customizing variables:                 Changing a Variable.
                                                             (line   35)
* cut:                                   Cut and Paste.      (line    6)
* cut and paste:                         Glossary.           (line  339)
* cutting text:                          Deletion and Killing.
                                                             (line    6)
* cvs:                                   VC Directory Mode.  (line   24)
* CVS:                                   Version Control Systems.
                                                             (line   25)
* CVS directory mode:                    VC Directory Mode.  (line   24)
* CWarn mode:                            Other C Commands.   (line   71)
* Cyrillic:                              Language Environments.
                                                             (line   30)
* Czech:                                 Language Environments.
                                                             (line   31)
* daemon, Emacs:                         Emacs Server.       (line   27)
* day of year:                           General Calendar.   (line   18)
* daylight saving time:                  Daylight Saving.    (line    6)
* DBX:                                   Debuggers.          (line    6)
* deactivating the mark:                 Mark.               (line   23)
* dead character:                        Unibyte Mode.       (line   63)
* debbugs package:                       Known Problems.     (line   23)
* debuggers:                             Debuggers.          (line    6)
* debugging Emacs, tricks and techniques: Checklist.         (line  284)
* debugging X problems:                  Table of Resources. (line  146)
* decentralized version control:         VCS Repositories.   (line    6)
* decoding mail messages (Rmail):        Rmail Coding.       (line    6)
* decoding non-ASCII keyboard input on X: Communication Coding.
                                                             (line   58)
* decrease buffer face height:           Text Scale.         (line   24)
* decrypting files (in Dired):           Operating on Files. (line  144)
* default argument:                      Basic Minibuffer.   (line   17)
* default directory:                     Minibuffer File.    (line    6)
* default directory, of a buffer:        File Names.         (line   22)
* default face:                          Faces.              (line   31)
* default file name:                     File Names.         (line    6)
* default search mode:                   Search Customizations.
                                                             (line    9)
* default.el file, not loading:          Initial Options.    (line   89)
* default.el, the default init file:     Init File.          (line   21)
* defining keyboard macros:              Keyboard Macros.    (line    6)
* defuns:                                Moving by Defuns.   (line    6)
* <DEL> does not delete:                 DEL Does Not Delete.
                                                             (line    6)
* <DEL> vs <BACKSPACE>:                  DEL Does Not Delete.
                                                             (line    6)
* Delete Selection mode:                 Using Region.       (line   50)
* delete window:                         Change Window.      (line    6)
* deleting auto-save files:              Flagging Many Files.
                                                             (line   30)
* deleting blank lines:                  Blank Lines.        (line    6)
* deleting characters and lines:         Erasing.            (line    6)
* deleting files (in Dired):             Dired Deletion.     (line    6)
* deleting rows and column in text-based tables: Table Rows and Columns.
                                                             (line   19)
* deleting some backup files:            Flagging Many Files.
                                                             (line   50)
* deleting windows:                      Change Window.      (line    6)
* deletion:                              Deletion and Killing.
                                                             (line    6)
* deletion (of files):                   Misc File Ops.      (line    9)
* deletion (Rmail):                      Rmail Deletion.     (line    6)
* desktop:                               Saving Emacs Sessions.
                                                             (line    6)
* desktop restore in daemon mode:        Saving Emacs Sessions.
                                                             (line   83)
* desktop shortcut, MS-Windows:          Windows Startup.    (line    8)
* deterministic build:                   Initial Options.    (line   82)
* Devanagari:                            Language Environments.
                                                             (line   31)
* device for Emacs terminal I/O:         Initial Options.    (line   27)
* dialog boxes:                          Dialog Boxes.       (line    6)
* Dialog X Resources (Lucid widgets):    Lucid Resources.    (line    6)
* diary:                                 Diary.              (line    6)
* diary buffer:                          Diary Display.      (line    6)
* diary file:                            Format of Diary File.
                                                             (line    6)
* Diff mode:                             Diff Mode.          (line    6)
* digest message:                        Rmail Digest.       (line    6)
* directional window selection:          Window Convenience. (line   26)
* directories in buffer names:           Uniquify.           (line    6)
* directory header lines:                Subdirectory Motion.
                                                             (line   10)
* directory listing:                     Directories.        (line    6)
* directory listing on MS-DOS:           MS-DOS Processes.   (line   44)
* directory name abbreviation:           File Aliases.       (line   33)
* directory tracking:                    Directory Tracking. (line    6)
* directory where Emacs starts on MS-Windows: Windows Startup.
                                                             (line    8)
* directory-local variables:             Directory Variables.
                                                             (line    6)
* Dired:                                 Dired.              (line    6)
* Dired and version control:             Misc Dired Features.
                                                             (line   51)
* Dired sorting:                         Dired Updating.     (line   67)
* Dired sorting order, on MS-Windows/MS-DOS: ls in Lisp.     (line   29)
* Dired, and MS-Windows/MS-DOS:          ls in Lisp.         (line    6)
* Dirtrack mode:                         Directory Tracking. (line   25)
* disable window system:                 Initial Options.    (line   37)
* disabled command:                      Disabling.          (line    6)
* disabling remote files:                Remote Files.       (line   25)
* DISPLAY environment variable:          Display X.          (line    6)
* display for Emacs frame:               Initial Options.    (line   32)
* display line numbers:                  Display Custom.     (line    9)
* display name (X Window System):        Display X.          (line    6)
* display of buffer size:                Optional Mode Line. (line    6)
* display of current line number:        Optional Mode Line. (line   18)
* display, incorrect:                    Screen Garbled.     (line    6)
* distributed version control:           VCS Repositories.   (line    6)
* DNS mode:                              Program Modes.      (line   15)
* DocTeX mode:                           TeX Mode.           (line    6)
* document viewer (DocView):             Document View.      (line    6)
* documentation string:                  Key Help.           (line   12)
* DocView mode:                          Document View.      (line    6)
* DOS applications, running from Emacs:  Windows Processes.  (line    6)
* DOS codepages:                         MS-DOS and MULE.    (line   21)
* DOS-style end-of-line display:         Recognize Coding.   (line   56)
* DOS-to-Unix conversion of files:       Text and Binary.    (line   39)
* double clicks:                         Mouse Buttons.      (line   28)
* double slash in file name:             Minibuffer File.    (line   34)
* down events:                           Mouse Buttons.      (line    6)
* downcase file names:                   Transforming File Names.
                                                             (line   27)
* drag and drop:                         Drag and Drop.      (line    6)
* drag and drop, Dired:                  Misc Dired Features.
                                                             (line   77)
* drag events:                           Mouse Buttons.      (line    6)
* drastic changes:                       Reverting.          (line    6)
* dribble file:                          Checklist.          (line  108)
* DSSSL mode:                            Program Modes.      (line   15)
* dunnet:                                Amusements.         (line   34)
* Dutch:                                 Language Environments.
                                                             (line   31)
* DVI file:                              Document View.      (line    6)
* early init file:                       Early Init File.    (line    6)
* Ebrowse:                               Tags Tables.        (line   26)
* echo area:                             Echo Area.          (line    6)
* echo area message:                     Echo Area.          (line   19)
* echoing:                               Echo Area.          (line    9)
* EDE (Emacs Development Environment):   EDE.                (line    6)
* Edebug:                                Checklist.          (line  189)
* editable fields (customization buffer): Customization Groups.
                                                             (line   38)
* editing binary files:                  Editing Binary Files.
                                                             (line    6)
* editing in Picture mode:               Basic Picture.      (line    6)
* editing level, recursive:              Recursive Edit.     (line    6)
* EDITOR environment variable:           Emacs Server.       (line    6)
* eight-bit character set:               International Chars.
                                                             (line   54)
* ElDoc mode:                            Lisp Doc.           (line   11)
* Electric Indent mode:                  Indent Convenience. (line   15)
* Electric Pair mode:                    Matching.           (line   61)
* Electric Quote mode:                   Quotation Marks.    (line    6)
* Eliza:                                 Amusements.         (line   62)
* Emacs as a server:                     Emacs Server.       (line    6)
* Emacs Development Environment:         EDE.                (line    6)
* Emacs icon, a gnu:                     Icons X.            (line   12)
* Emacs initialization file:             Init File.          (line    6)
* Emacs Lisp mode:                       Lisp Eval.          (line    6)
* Emacs Lisp package archive:            Packages.           (line   16)
* emacs-internal, coding system:         Coding Systems.     (line  111)
* emacs22, completion style:             Completion Styles.  (line   41)
* emacsclient:                           Emacs Server.       (line    6)
* emacsclient invocation:                Invoking emacsclient.
                                                             (line    6)
* emacsclient options:                   emacsclient Options.
                                                             (line    6)
* emacsclient, on MS-Windows:            Windows Startup.    (line   72)
* emacsclient.exe:                       Windows Startup.    (line   48)
* emacsclientw.exe:                      Windows Startup.    (line   48)
* emacs_backtrace.txt file, MS-Windows:  Crashing.           (line    6)
* email:                                 Sending Mail.       (line    6)
* embedded widgets:                      Embedded WebKit Widgets.
                                                             (line    6)
* Emerge:                                Emerge.             (line    6)
* emergency escape:                      Emergency Escape.   (line    6)
* enabling Transient Mark mode temporarily: Disabled Transient Mark.
                                                             (line   29)
* encoding of characters:                International.      (line    6)
* encrypted mails (reading in Rmail):    Rmail Display.      (line   83)
* encrypting files (in Dired):           Operating on Files. (line  156)
* encryption:                            Network Security.   (line    6)
* end-of-line convention, mode-line indication: Mode Line.   (line   40)
* end-of-line conversion:                Coding Systems.     (line   56)
* end-of-line conversion on MS-DOS/MS-Windows: Text and Binary.
                                                             (line    9)
* English:                               Language Environments.
                                                             (line   31)
* Enriched mode:                         Enriched Text.      (line    6)
* enriched text:                         Enriched Text.      (line    6)
* entering Emacs:                        Entering Emacs.     (line    6)
* environment variables:                 Environment.        (line    6)
* environment variables (macOS):         Mac / GNUstep Basics.
                                                             (line   33)
* environment variables for subshells:   Interactive Shell.  (line   36)
* environment variables in file names:   File Names.         (line   53)
* equivalent character sequences:        Lax Search.         (line   77)
* erasing characters and lines:          Erasing.            (line    6)
* error log:                             Compilation.        (line    6)
* error message:                         Echo Area.          (line   19)
* errors in init file:                   Initial Options.    (line  142)
* <ESC> replacing <Meta> key:            User Input.         (line   27)
* escape sequences in files:             Recognize Coding.   (line   67)
* escape-glyph face:                     Text Display.       (line   35)
* ESHELL environment variable:           Interactive Shell.  (line   36)
* Esperanto:                             Language Environments.
                                                             (line   32)
* etags:                                 Tags Tables.        (line   14)
* etags program:                         Create Tags Table.  (line    6)
* Ethiopic:                              Language Environments.
                                                             (line   32)
* Ethiopic calendar:                     Calendar Systems.   (line   41)
* European character sets:               Unibyte Mode.       (line    6)
* evaluate expression, command-line argument: Action Arguments.
                                                             (line   65)
* evaluation, Emacs Lisp:                Lisp Eval.          (line    6)
* events on macOS:                       Mac / GNUstep Events.
                                                             (line    6)
* exit incremental search:               Basic Isearch.      (line   36)
* exiting:                               Exiting.            (line    6)
* exiting recursive edit:                Recursive Edit.     (line   13)
* expanding subdirectories in Dired:     Subdirectories in Dired.
                                                             (line    6)
* expansion (of abbrevs):                Abbrevs.            (line    6)
* expansion of C macros:                 Other C Commands.   (line   34)
* expansion of environment variables:    File Names.         (line   53)
* expression:                            Expressions.        (line    6)
* expunging (Rmail):                     Rmail Deletion.     (line   11)
* face at point:                         International Chars.
                                                             (line   65)
* face colors, setting:                  Colors.             (line   41)
* faces:                                 Faces.              (line    6)
* faces for highlighting query replace:  Query Replace.      (line   34)
* faces for highlighting search matches: Basic Isearch.      (line   21)
* faces for mode lines:                  Standard Faces.     (line   80)
* faces for text-mode menus:             Standard Faces.     (line  152)
* faces under MS-DOS:                    MS-DOS Display.     (line    6)
* faces, customizing:                    Face Customization. (line    6)
* failed merges:                         Comparing Files.    (line   54)
* Feedmail:                              Mail Sending.       (line   28)
* FFAP minor mode:                       FFAP.               (line   18)
* fido mode:                             Icomplete.          (line   26)
* file archives:                         File Archives.      (line    6)
* file comparison (in Dired):            Comparison in Dired.
                                                             (line    6)
* file database (locate):                Dired and Find.     (line   37)
* file dates:                            Interlocking.       (line    6)
* file directory:                        Directories.        (line    6)
* file local variables:                  File Variables.     (line    6)
* file locking:                          Interlocking.       (line   18)
* file management:                       Dired.              (line    6)
* file modes:                            Misc File Ops.      (line   49)
* file name caching:                     File Name Cache.    (line    6)
* file names:                            File Names.         (line    6)
* file names on MS-Windows:              Windows Files.      (line    6)
* file names under MS-DOS:               MS-DOS File Names.  (line    6)
* file names under Windows 95/NT:        MS-DOS File Names.  (line   26)
* file names with non-ASCII characters:  File Name Coding.   (line   10)
* file names, invalid characters on MS-Windows: Windows Files.
                                                             (line   33)
* file names, quote special characters:  Quoted File Names.  (line    6)
* file notifications:                    Auto Revert.        (line   31)
* file ownership, and backup:            Backup Copying.     (line   20)
* file permissions:                      Misc File Ops.      (line   49)
* file selection dialog:                 Visiting.           (line  123)
* file selection dialog, how to disable: Dialog Boxes.       (line   17)
* file shadows:                          File Shadowing.     (line    6)
* file truenames:                        File Aliases.       (line   27)
* file version in change log entries:    Change Log Commands.
                                                             (line   34)
* file, warning when size is large:      Visiting.           (line   62)
* file-based version control:            VCS Changesets.     (line    6)
* file-name completion, on MS-Windows:   Windows Files.      (line   11)
* file-name encoding, MS-Windows:        File Name Coding.   (line   28)
* files:                                 Files.              (line    6)
* files, visiting and saving:            Visiting.           (line   23)
* filesets:                              Filesets.           (line    6)
* filesets, VC:                          Basic VC Editing.   (line    6)
* fill prefix:                           Fill Prefix.        (line    6)
* filling text:                          Filling.            (line    6)
* find:                                  File Name Cache.    (line    6)
* find and Dired:                        Dired and Find.     (line    6)
* find definition of symbols:            Looking Up Identifiers.
                                                             (line    6)
* find Info manual by its file name:     Misc Help.          (line   12)
* find references to symbols:            Looking Up Identifiers.
                                                             (line    6)
* finder:                                Package Keywords.   (line    6)
* finding file at point:                 FFAP.               (line    6)
* finding files containing regexp matches (in Dired): Marks vs Flags.
                                                             (line  128)
* finding strings within text:           Search.             (line    6)
* firewall, and accessing remote files:  Remote Files.       (line   57)
* fixing incorrectly decoded mail messages: Rmail Coding.    (line   16)
* flagging files (in Dired):             Dired Deletion.     (line    6)
* flagging many files for deletion (in Dired): Flagging Many Files.
                                                             (line    6)
* Flyspell mode:                         Spelling.           (line  155)
* folding editing:                       Foldout.            (line    6)
* Follow mode:                           Follow Mode.        (line    6)
* font antialiasing (MS Windows):        Windows Fonts.      (line  107)
* font backend selection (MS-Windows):   Windows Fonts.      (line   15)
* font for menus (X resource):           Table of Resources. (line   95)
* Font Lock mode:                        Font Lock.          (line    6)
* font lookup, MS-Windows:               Windows Fonts.      (line  115)
* font name (X Window System):           Font X.             (line    6)
* font of character at point:            International Chars.
                                                             (line   65)
* font properties (MS Windows):          Windows Fonts.      (line   49)
* font scripts (MS Windows):             Windows Fonts.      (line   98)
* font specification (MS Windows):       Windows Fonts.      (line    6)
* font Unicode subranges (MS Windows):   Windows Fonts.      (line   98)
* fontconfig:                            Fonts.              (line   48)
* fonts:                                 Fonts.              (line    6)
* fonts and faces:                       Face Customization. (line    6)
* fonts for PostScript printing:         PostScript Variables.
                                                             (line   52)
* fonts for various scripts:             Fontsets.           (line   14)
* fonts, emulating under MS-DOS:         MS-DOS Display.     (line    6)
* fonts, how to ignore:                  Modifying Fontsets. (line   62)
* fontsets:                              Fontsets.           (line    6)
* fontsets, modifying:                   Modifying Fontsets. (line    6)
* foreground color, command-line argument: Colors X.         (line   12)
* foreground for menus (X resource):     Table of Resources. (line  100)
* formfeed character:                    Pages.              (line    6)
* Fortran 77 and Fortran 90, 95, 2003, 2008: Fortran.        (line    6)
* Fortran continuation lines:            ForIndent Cont.     (line    6)
* Fortran fixed form and free form:      Fortran.            (line    6)
* Fortran mode:                          Fortran.            (line    6)
* fortune cookies:                       Mail Amusements.    (line   19)
* forwarding a message:                  Rmail Reply.        (line   68)
* frame:                                 Screen.             (line    6)
* frame focus policy, MS-Windows:        Windows Misc.       (line   18)
* frame size under MS-DOS:               MS-DOS Display.     (line   42)
* frame size, specifying default:        Frame Parameters.   (line   13)
* frame title, command-line argument:    Title X.            (line   16)
* frames:                                Frames.             (line    6)
* frames on MS-DOS:                      MS-DOS Display.     (line   36)
* French:                                Language Environments.
                                                             (line   32)
* French Revolutionary calendar:         Calendar Systems.   (line   29)
* fringe face:                           Standard Faces.     (line  121)
* fringes:                               Fringes.            (line    6)
* fringes, and continuation lines:       Continuation Lines. (line    6)
* fringes, and unused line indication:   Useless Whitespace. (line   28)
* fringes, for debugging:                Source Buffers.     (line    6)
* FTP:                                   Remote Files.       (line    6)
* fullheight, command-line argument:     Window Size X.      (line   32)
* fullscreen, command-line argument:     Window Size X.      (line   18)
* fullwidth, command-line argument:      Window Size X.      (line   36)
* function key:                          Keymaps.            (line   35)
* function, move to beginning or end:    Moving by Defuns.   (line   17)
* future history for file names:         Minibuffer History. (line   43)
* games:                                 Amusements.         (line    6)
* gamma correction (X resource):         Table of Resources. (line  118)
* garbled display:                       Screen Garbled.     (line    6)
* garbled text:                          Text Garbled.       (line    6)
* gateway, and remote file access with ange-ftp: Remote Files.
                                                             (line   57)
* GDB:                                   Debuggers.          (line    6)
* GDB User Interface layout:             GDB User Interface Layout.
                                                             (line    6)
* geometry of Emacs window:              Window Size X.      (line    6)
* geometry, command-line argument:       Window Size X.      (line   11)
* Georgian:                              Language Environments.
                                                             (line   32)
* German:                                Language Environments.
                                                             (line   32)
* getting help with keys:                Basic Help.         (line    6)
* Ghostscript, use for PostScript printing: Windows Printing.
                                                             (line   97)
* git:                                   Version Control Systems.
                                                             (line   38)
* Glasses mode:                          MixedCase Words.    (line   12)
* Global Auto Revert mode:               Auto Revert.        (line    6)
* global keymap:                         Keymaps.            (line   21)
* global mark:                           CUA Bindings.       (line   47)
* global mark ring:                      Global Mark Ring.   (line    6)
* global substitution:                   Replace.            (line    6)
* glossary:                              Glossary.           (line    6)
* glyphless characters:                  Text Display.       (line   52)
* glyphless-char face:                   Text Display.       (line   52)
* gnu.emacs.help newsgroup:              Service.            (line    6)
* Gnus:                                  Gnus.               (line    6)
* GNUstep:                               Mac OS / GNUstep.   (line    6)
* Go Moku:                               Amusements.         (line   36)
* Goto Address mode:                     Goto Address mode.  (line    6)
* graphic characters:                    Inserting Text.     (line    6)
* Greek:                                 Language Environments.
                                                             (line   32)
* Gregorian calendar:                    Other Calendars.    (line    6)
* growing minibuffer:                    Minibuffer Edit.    (line   26)
* GTK font pattern:                      Fonts.              (line   98)
* GTK+ resources:                        GTK resources.      (line    6)
* GTK+ styles:                           GTK styles.         (line    6)
* GTK+ widget classes:                   GTK Names in Emacs. (line    6)
* GTK+ widget names:                     GTK Widget Names.   (line    6)
* GTK+ widget names in Emacs:            GTK Names in Emacs. (line    6)
* GUD interaction buffer:                Debugger Operation. (line    6)
* GUD library:                           Debuggers.          (line    6)
* GUD Tooltip mode:                      Debugger Operation. (line   32)
* guillemets:                            Quotation Marks.    (line    6)
* Gujarati:                              Language Environments.
                                                             (line   32)
* gzip:                                  Compressed Files.   (line    6)
* H-:                                    Modifier Keys.      (line   26)
* Han:                                   International.      (line    6)
* handwriting:                           PostScript.         (line   54)
* Hangul:                                International.      (line    6)
* hard links (creation):                 Copying and Naming. (line   40)
* hard links (in Dired):                 Operating on Files. (line   84)
* hard links (visiting):                 File Aliases.       (line    6)
* hard newline:                          Hard and Soft Newlines.
                                                             (line    6)
* hardcopy:                              Printing.           (line    6)
* header (TeX mode):                     TeX Print.          (line   97)
* header line (Dired):                   Subdirectory Motion.
                                                             (line   10)
* header-line face:                      Standard Faces.     (line   97)
* header-line-highlight face:            Standard Faces.     (line  102)
* headers (of mail message):             Mail Headers.       (line    6)
* heading lines (Outline mode):          Outline Format.     (line    6)
* Hebrew:                                Language Environments.
                                                             (line   33)
* Hebrew calendar:                       Calendar Systems.   (line   16)
* height of minibuffer:                  Minibuffer Edit.    (line   26)
* height of the horizontal scroll bar:   Scroll Bars.        (line   89)
* help:                                  Help.               (line    6)
* help in using Emacs:                   Service.            (line    6)
* help text, in GTK+ file chooser:       Dialog Boxes.       (line   23)
* help, viewing web pages:               Help Mode.          (line   38)
* help-gnu-emacs mailing list:           Service.            (line    6)
* hex editing:                           Editing Binary Files.
                                                             (line    6)
* Hexl mode:                             Editing Binary Files.
                                                             (line    6)
* hg:                                    Version Control Systems.
                                                             (line   43)
* Hi Lock mode:                          Highlight Interactively.
                                                             (line   11)
* hidden files, in GTK+ file chooser:    Dialog Boxes.       (line   23)
* Hide-ifdef mode:                       Other C Commands.   (line   86)
* Hideshow mode:                         Hideshow.           (line    6)
* hiding details in Dired:               Misc Dired Features.
                                                             (line   43)
* hiding subdirectories (Dired):         Hiding Subdirectories.
                                                             (line    6)
* Highlight Changes mode:                Highlight Interactively.
                                                             (line    6)
* highlight current line:                Cursor Display.     (line   53)
* highlighting by matching:              Highlight Interactively.
                                                             (line    6)
* highlighting lines of text:            Highlight Interactively.
                                                             (line   60)
* highlighting matching parentheses:     Matching.           (line   34)
* highlighting phrase:                   Highlight Interactively.
                                                             (line   65)
* highlighting region:                   Disabled Transient Mark.
                                                             (line    6)
* highlighting symbol at point:          Highlight Interactively.
                                                             (line   72)
* Hindi:                                 International.      (line    6)
* history of commands:                   Repetition.         (line    6)
* history of minibuffer input:           Minibuffer History. (line    6)
* history reference:                     History References. (line    6)
* holiday forms:                         Holiday Customizing.
                                                             (line   32)
* holidays:                              Holidays.           (line    6)
* HOME directory on MS-Windows:          Windows HOME.       (line    6)
* home directory shorthand:              Minibuffer File.    (line   47)
* HOME directory under MS-DOS:           MS-DOS File Names.  (line   35)
* homoglyph face:                        Text Display.       (line   63)
* hook:                                  Hooks.              (line    6)
* Horizontal Scroll Bar:                 Scroll Bars.        (line   66)
* Horizontal Scroll Bar mode:            Scroll Bars.        (line   66)
* horizontal scrolling:                  Horizontal Scrolling.
                                                             (line    6)
* hourglass pointer display:             Display Custom.     (line   97)
* HTML mode:                             HTML Mode.          (line    6)
* hungry deletion (C Mode):              Hungry Delete.      (line    6)
* hunk, diff:                            Diff Mode.          (line   11)
* Hyper (under MS-DOS):                  MS-DOS Keyboard.    (line   20)
* Hyper, modifier key:                   Modifier Keys.      (line   26)
* hyperlink:                             Help Mode.          (line   29)
* hyperlinks:                            Mouse References.   (line    6)
* iCalendar support:                     Importing Diary.    (line   16)
* Icomplete mode:                        Icomplete.          (line    6)
* Icon mode:                             Program Modes.      (line   15)
* iconifying:                            Exiting.            (line   47)
* icons (X Window System):               Icons X.            (line    6)
* icons, toolbar:                        Tool Bars.          (line    6)
* identifier, finding definition of:     Looking Up Identifiers.
                                                             (line    6)
* IDL mode:                              C Modes.            (line    6)
* ignore font:                           Modifying Fontsets. (line   62)
* ignored file names, in completion:     Completion Options. (line   19)
* image animation:                       Image Mode.         (line   43)
* image-dired:                           Image-Dired.        (line    6)
* image-dired mode:                      Image-Dired.        (line    6)
* ImageMagick support:                   Image Mode.         (line   55)
* images, viewing:                       Image Mode.         (line    6)
* IMAP mailboxes:                        Remote Mailboxes.   (line   32)
* in-situ subdirectory (Dired):          Subdirectories in Dired.
                                                             (line   19)
* inbox file:                            Rmail Inbox.        (line    6)
* incorrect fontification:               Font Lock.          (line   54)
* increase buffer face height:           Text Scale.         (line   24)
* incremental search:                    Incremental Search. (line    6)
* incremental search, edit search string: Repeat Isearch.    (line   57)
* incremental search, exiting:           Basic Isearch.      (line   36)
* incremental search, go to first or last occurrence: Special Isearch.
                                                             (line   98)
* incremental search, help on special keys: Special Isearch. (line   93)
* incremental search, input method interference: Input Methods.
                                                             (line   85)
* indentation:                           Indentation.        (line    6)
* indentation for comments:              Comment Commands.   (line    6)
* indentation for programs:              Program Indent.     (line    6)
* index of buffer definitions:           Imenu.              (line    6)
* indirect buffer:                       Indirect Buffers.   (line    6)
* indirect buffers and outlines:         Outline Views.      (line    6)
* inferior process:                      Compilation.        (line    6)
* inferior processes under MS-DOS:       MS-DOS Processes.   (line    6)
* Info:                                  Misc Help.          (line    6)
* init file:                             Init File.          (line    6)
* init file .emacs on MS-Windows:        Windows HOME.       (line   41)
* init file, default name under MS-DOS:  MS-DOS File Names.  (line    6)
* init file, not loading:                Initial Options.    (line   89)
* initial options (command line):        Emacs Invocation.   (line   40)
* initials, completion style:            Completion Styles.  (line   58)
* input event:                           User Input.         (line   44)
* input item, isearch:                   Basic Isearch.      (line   27)
* input methods:                         Input Methods.      (line    6)
* input methods, X:                      Table of Resources. (line  161)
* input with the keyboard:               User Input.         (line    6)
* insert file contents, command-line argument: Action Arguments.
                                                             (line   68)
* insert Unicode character:              Inserting Text.     (line   60)
* inserted subdirectory (Dired):         Subdirectories in Dired.
                                                             (line   19)
* inserting blank lines:                 Blank Lines.        (line    6)
* inserting matching parentheses:        Matching.           (line   61)
* inserting rows and columns in text-based tables: Table Rows and Columns.
                                                             (line    6)
* insertion:                             Inserting Text.     (line    6)
* INSIDE_EMACS environment variable:     Interactive Shell.  (line   55)
* Integrated development environment:    EDE.                (line    6)
* interactive highlighting:              Highlight Interactively.
                                                             (line    6)
* interactively edit search string:      Repeat Isearch.     (line   57)
* internal border width, command-line argument: Borders X.   (line   15)
* international characters in .emacs:    Init Non-ASCII.     (line    6)
* international files from DOS/Windows systems: Coding Systems.
                                                             (line   20)
* international scripts:                 International.      (line    6)
* international support (MS-DOS):        MS-DOS and MULE.    (line    6)
* Internet search:                       Word Search.        (line   55)
* Intlfonts for PostScript printing:     PostScript Variables.
                                                             (line   52)
* Intlfonts package, installation:       Fontsets.           (line   14)
* invisible lines:                       Outline Mode.       (line    6)
* invisible text, and query-replace:     Query Replace.      (line  148)
* invisible text, searching for:         Special Isearch.    (line   22)
* invocation (command line arguments):   Emacs Invocation.   (line    6)
* invoking Emacs from Windows Explorer:  Windows Startup.    (line   48)
* IPA:                                   Language Environments.
                                                             (line   33)
* isearch:                               Incremental Search. (line    6)
* isearch face:                          Basic Isearch.      (line   21)
* isearch input item:                    Basic Isearch.      (line   27)
* isearch multiple buffers:              Other Repeating Search.
                                                             (line   13)
* isearch multiple files:                Other Repeating Search.
                                                             (line   25)
* isearch-fail face:                     Error in Isearch.   (line    6)
* Islamic calendar:                      Calendar Systems.   (line   20)
* ISO commercial calendar:               Calendar Systems.   (line    6)
* ISO Latin character sets:              Unibyte Mode.       (line    6)
* iso-ascii library:                     Unibyte Mode.       (line   29)
* iso-transl library:                    Unibyte Mode.       (line   63)
* ispell program:                        Spelling.           (line  130)
* Italian:                               Language Environments.
                                                             (line   33)
* Japanese:                              Language Environments.
                                                             (line   33)
* jar:                                   File Archives.      (line   45)
* Java class archives:                   File Archives.      (line   45)
* Java mode:                             C Modes.            (line    6)
* Javascript mode:                       Program Modes.      (line   15)
* JDB:                                   Debuggers.          (line    6)
* Julian calendar:                       Calendar Systems.   (line    8)
* Julian day numbers:                    Calendar Systems.   (line   12)
* just-in-time (JIT) font-lock:          Font Lock.          (line   79)
* justification:                         Fill Commands.      (line   34)
* justification in text-based tables:    Cell Justification. (line    6)
* justification style:                   Enriched Justification.
                                                             (line    6)
* Kannada:                               Language Environments.
                                                             (line   33)
* Kerberos POP3 authentication:          Remote Mailboxes.   (line   55)
* key:                                   Keys.               (line   10)
* key bindings:                          Key Bindings.       (line    6)
* key rebinding, permanent:              Init Rebinding.     (line    6)
* key rebinding, this session:           Rebinding.          (line    6)
* key sequence:                          Keys.               (line   10)
* keyboard input:                        User Input.         (line    6)
* keyboard macro:                        Keyboard Macros.    (line    6)
* keyboard macros, in registers:         Keyboard Macro Registers.
                                                             (line    6)
* keyboard shortcuts:                    Glossary.           (line  781)
* keyboard, MS-Windows:                  Windows Keyboard.   (line    6)
* keymap:                                Keymaps.            (line    6)
* keypad:                                Function Keys.      (line   48)
* keypad keys (MS-Windows):              Windows Keyboard.   (line   84)
* keys stolen by window manager:         User Input.         (line   38)
* keys, reserved:                        Key Bindings.       (line   11)
* Khmer:                                 Language Environments.
                                                             (line   33)
* kill DOS application:                  Windows Processes.  (line   37)
* kill ring:                             Yanking.            (line    6)
* killing buffers:                       Kill Buffer.        (line    6)
* killing characters and lines:          Erasing.            (line    6)
* killing Emacs:                         Exiting.            (line    6)
* killing expressions:                   Expressions.        (line   44)
* killing rectangular areas of text:     Rectangles.         (line    6)
* killing text:                          Deletion and Killing.
                                                             (line    6)
* killing unsaved buffers:               Kill Buffer.        (line   22)
* Korean:                                Language Environments.
                                                             (line   33)
* label (Rmail):                         Rmail Labels.       (line    6)
* language environment, automatic selection on MS-DOS: MS-DOS and MULE.
                                                             (line   46)
* language environments:                 Language Environments.
                                                             (line    6)
* Lao:                                   Language Environments.
                                                             (line   33)
* LaTeX mode:                            TeX Mode.           (line    6)
* Latin:                                 Language Environments.
                                                             (line   34)
* Latin-1 TeX encoding:                  TeX Misc.           (line   12)
* Latvian:                               Language Environments.
                                                             (line   35)
* lax search:                            Lax Search.         (line    6)
* lax space matching in replace commands: Replacement and Lax Matches.
                                                             (line   11)
* lax space matching in search:          Lax Search.         (line   15)
* lazy highlighting customizations:      Search Customizations.
                                                             (line   23)
* lazy search highlighting:              Repeat Isearch.     (line   18)
* lazy-highlight face:                   Search Customizations.
                                                             (line   23)
* lazy-highlight face, in replace:       Query Replace.      (line   34)
* leaving Emacs:                         Exiting.            (line    6)
* libraries:                             Lisp Libraries.     (line    6)
* Life:                                  Amusements.         (line   43)
* line endings:                          Coding Systems.     (line   56)
* line mode (terminal emulator):         Terminal emulator.  (line   10)
* line number commands:                  Position Info.      (line   37)
* line number display:                   Optional Mode Line. (line   18)
* line spacing (X resource):             Table of Resources. (line   79)
* line spacing, command-line argument:   Misc X.             (line   17)
* line truncation:                       Line Truncation.    (line    6)
* line truncation, and fringes:          Continuation Lines. (line   20)
* line wrapping:                         Continuation Lines. (line    6)
* line-number face:                      Display Custom.     (line   76)
* lines, highlighting:                   Highlight Interactively.
                                                             (line   60)
* links:                                 Mouse References.   (line    6)
* links (customization buffer):          Customization Groups.
                                                             (line   38)
* Lisp character syntax:                 Init Syntax.        (line   52)
* Lisp editing:                          Programs.           (line    6)
* Lisp files byte-compiled by XEmacs:    Lisp Libraries.     (line   87)
* Lisp mode:                             External Lisp.      (line    6)
* Lisp object syntax:                    Init Syntax.        (line   68)
* Lisp string syntax:                    Init Syntax.        (line   30)
* Lisp symbol completion:                Symbol Completion.  (line   14)
* lisp-indent-function property:         Lisp Indent.        (line   27)
* list commands:                         Moving by Parens.   (line    6)
* listing current buffers:               List Buffers.       (line    9)
* listing system fonts:                  Fonts.              (line  204)
* Lithuanian:                            Language Environments.
                                                             (line   35)
* load init file of another user:        Initial Options.    (line  139)
* load path for Emacs Lisp:              Lisp Libraries.     (line   21)
* loading Lisp code:                     Lisp Libraries.     (line    6)
* loading Lisp libraries automatically:  Init Examples.      (line   81)
* loading Lisp libraries, command-line argument: Action Arguments.
                                                             (line   38)
* loading several files (in Dired):      Operating on Files. (line  160)
* local keymap:                          Local Keymaps.      (line    6)
* local variables:                       Locals.             (line   16)
* local variables in files:              File Variables.     (line    6)
* local variables, for all files in a directory: Directory Variables.
                                                             (line    6)
* local variables, for all remote connections: Connection Variables.
                                                             (line    6)
* locale, date format:                   Time Stamps.        (line    6)
* locales:                               Language Environments.
                                                             (line   45)
* location of point:                     Position Info.      (line   37)
* locking (CVS):                         CVS Options.        (line   46)
* locking files:                         Interlocking.       (line   18)
* locking, non-strict (RCS):             RCS and SCCS.       (line    6)
* locking-based version:                 VCS Merging.        (line   15)
* locus:                                 Compilation Mode.   (line    6)
* Log Edit mode:                         Log Buffer.         (line   12)
* log File, types of:                    Types of Log File.  (line    6)
* logging keystrokes:                    Checklist.          (line  108)
* logical order:                         Bidirectional Editing.
                                                             (line   19)
* long file names in DOS box under Windows 95/NT: MS-DOS File Names.
                                                             (line   26)
* long lines:                            Long Lines.         (line    6)
* looking for a subject in documentation: Help.              (line   17)
* lpr usage under MS-DOS:                Windows Printing.   (line   79)
* LRM:                                   Bidirectional Editing.
                                                             (line   60)
* ls emulation:                          ls in Lisp.         (line    6)
* Lucid Widget X Resources:              Lucid Resources.    (line    6)
* lzh:                                   File Archives.      (line   45)
* M-:                                    User Input.         (line   18)
* M-<TAB> vs <Alt>-<TAB> (MS-Windows):   Windows Keyboard.   (line   48)
* M4 mode:                               Program Modes.      (line   15)
* Macintosh:                             Mac OS / GNUstep.   (line    6)
* Macintosh end-of-line conversion:      Coding Systems.     (line   56)
* macOS:                                 Mac OS / GNUstep.   (line    6)
* macro expansion in C:                  Other C Commands.   (line   34)
* mail:                                  Sending Mail.       (line    6)
* mail (on mode line):                   Optional Mode Line. (line   68)
* mail aliases:                          Mail Aliases.       (line    6)
* MAIL environment variable:             Rmail Inbox.        (line   14)
* Mail mode:                             Mail Methods.       (line    6)
* mail signature:                        Mail Signature.     (line    6)
* mail-composition methods:              Mail Methods.       (line    6)
* Mailclient:                            Mail Sending.       (line   28)
* MAILHOST environment variable:         Remote Mailboxes.   (line   14)
* mailrc file:                           Mail Aliases.       (line    6)
* main border width, command-line argument: Borders X.       (line   20)
* major modes:                           Major Modes.        (line    6)
* make:                                  Compilation.        (line    6)
* Makefile mode:                         Program Modes.      (line   15)
* making pictures out of text characters: Picture Mode.      (line    6)
* Malayalam:                             Language Environments.
                                                             (line   35)
* man page:                              Man Page.           (line    6)
* man pages, and local file variables:   Specifying File Variables.
                                                             (line   35)
* manipulating paragraphs:               Paragraphs.         (line    6)
* manipulating sentences:                Sentences.          (line    6)
* manipulating text:                     Text.               (line    6)
* manual pages, on MS-DOS/MS-Windows:    Man Page.           (line   40)
* manual version backups:                CVS Options.        (line   39)
* manuals, included:                     Misc Help.          (line    6)
* mark:                                  Mark.               (line    6)
* mark rectangle:                        Rectangles.         (line   13)
* mark ring:                             Mark Ring.          (line    6)
* marking executable files (in Dired):   Marks vs Flags.     (line   30)
* marking many files (in Dired):         Marks vs Flags.     (line    6)
* marking sections of text:              Marking Objects.    (line    6)
* marking subdirectories (in Dired):     Marks vs Flags.     (line   38)
* marking symbolic links (in Dired):     Marks vs Flags.     (line   34)
* match (face name):                     Other Repeating Search.
                                                             (line   41)
* matching parentheses:                  Matching.           (line    6)
* matching parenthesis and braces, moving to: Moving by Parens.
                                                             (line    6)
* maximized, command-line argument:      Window Size X.      (line   25)
* maximum buffer size exceeded, error message: Visiting.     (line   62)
* Mayan calendar:                        Mayan Calendar.     (line    6)
* Mayan calendar round:                  Mayan Calendar.     (line   58)
* Mayan calendars:                       Calendar Systems.   (line   35)
* Mayan haab calendar:                   Mayan Calendar.     (line   50)
* Mayan long count:                      Mayan Calendar.     (line   30)
* Mayan tzolkin calendar:                Mayan Calendar.     (line   42)
* mbox files:                            Rmail Inbox.        (line   41)
* memory full:                           Memory Full.        (line    6)
* menu bar:                              Menu Bar.           (line    6)
* menu bar (X resource):                 Table of Resources. (line   87)
* menu bar access using keyboard:        Menu Bar.           (line   22)
* menu bar appearance:                   Standard Faces.     (line  149)
* menu bar mode:                         Menu Bars.          (line    6)
* menu face, no effect if customized:    Standard Faces.     (line  149)
* Menu X Resources (Lucid widgets):      Lucid Resources.    (line    6)
* Menu X Resources (Motif widgets):      Motif Resources.    (line    6)
* Mercurial:                             Version Control Systems.
                                                             (line   43)
* merge buffer (Emerge):                 Overview of Emerge. (line   21)
* merge mail from file (Rmail):          Rmail Files.        (line   54)
* merges, failed:                        Comparing Files.    (line   54)
* merging changes:                       Merging.            (line    6)
* merging files:                         Emerge.             (line    6)
* merging-based version:                 VCS Merging.        (line   10)
* message:                               Sending Mail.       (line    6)
* Message mode:                          Mail Commands.      (line    6)
* Message mode for sending mail:         Mail Methods.       (line    6)
* message number (Rmail):                Rmail Basics.       (line   20)
* messages saved from echo area:         Echo Area.          (line   34)
* META:                                  User Input.         (line   18)
* Meta (under MS-DOS):                   MS-DOS Keyboard.    (line   20)
* Meta commands and words:               Words.              (line    6)
* Metafont mode:                         Program Modes.      (line   15)
* MH mail interface:                     Mail Methods.       (line    6)
* Microsoft Office file:                 Document View.      (line    6)
* Microsoft Windows:                     Microsoft Windows.  (line    6)
* Midnight mode:                         Kill Buffer.        (line   61)
* MIME:                                  Mail Misc.          (line    6)
* MIME messages (Rmail):                 Rmail Display.      (line   38)
* minibuffer:                            Minibuffer.         (line    6)
* minibuffer confirmation:               Completion Exit.    (line   34)
* minibuffer defaults for file names:    Minibuffer History. (line   43)
* Minibuffer Electric Default mode:      Basic Minibuffer.   (line   23)
* minibuffer history:                    Minibuffer History. (line    6)
* minibuffer history, searching:         Isearch Minibuffer. (line    6)
* minibuffer keymaps:                    Minibuffer Maps.    (line    6)
* minibuffer-prompt face:                Standard Faces.     (line  114)
* minimizing:                            Exiting.            (line   47)
* minimizing a frame at startup:         Icons X.            (line    6)
* minor mode keymap:                     Local Keymaps.      (line    6)
* minor modes:                           Minor Modes.        (line    6)
* mistakes, correcting:                  Fixit.              (line    6)
* mode commands for minor modes:         Minor Modes.        (line   19)
* mode hook:                             Major Modes.        (line   71)
* mode hook, and major modes:            Program Modes.      (line   40)
* mode line:                             Mode Line.          (line    6)
* mode line (MS-DOS):                    MS-DOS and MULE.    (line   63)
* mode line, 3D appearance:              Optional Mode Line. (line   86)
* mode line, mouse:                      Mode Line Mouse.    (line    6)
* mode, Abbrev:                          Abbrev Concepts.    (line   12)
* mode, archive:                         File Archives.      (line   45)
* mode, Auto Compression:                Compressed Files.   (line    6)
* mode, Auto Fill:                       Auto Fill.          (line    6)
* mode, Auto Revert:                     Auto Revert.        (line    6)
* mode, Auto Save:                       Auto Save.          (line    6)
* mode, AWK:                             C Modes.            (line    6)
* mode, C:                               C Modes.            (line    6)
* mode, C++:                             C Modes.            (line    6)
* mode, Column Number:                   Optional Mode Line. (line   23)
* mode, Comint:                          Shell Mode.         (line  147)
* mode, Compilation:                     Compilation Mode.   (line    6)
* mode, CORBA IDL:                       C Modes.            (line    6)
* mode, Delete Selection:                Using Region.       (line   50)
* mode, Dirtrack:                        Directory Tracking. (line   25)
* mode, display-fill-column-indicator:   Displaying Boundaries.
                                                             (line    6)
* mode, DocTeX:                          TeX Mode.           (line    6)
* mode, DocView:                         Document View.      (line    6)
* mode, Electric Indent:                 Indent Convenience. (line   15)
* mode, Electric Quote:                  Quotation Marks.    (line    6)
* mode, Emacs Lisp:                      Lisp Eval.          (line    6)
* mode, Enriched:                        Enriched Text.      (line    6)
* mode, Flyspell:                        Spelling.           (line  155)
* mode, Follow:                          Follow Mode.        (line    6)
* mode, Font Lock:                       Font Lock.          (line    6)
* mode, Fortran:                         Fortran.            (line    6)
* mode, Glasses:                         MixedCase Words.    (line   12)
* mode, Global Auto Revert:              Auto Revert.        (line    6)
* mode, Goto Address:                    Goto Address mode.  (line    6)
* mode, GUD Tooltip:                     Debugger Operation. (line   32)
* mode, Hexl:                            Editing Binary Files.
                                                             (line    6)
* mode, Hideshow:                        Hideshow.           (line    6)
* mode, HTML:                            HTML Mode.          (line    6)
* mode, Java:                            C Modes.            (line    6)
* mode, LaTeX:                           TeX Mode.           (line    6)
* mode, Lisp:                            External Lisp.      (line    6)
* mode, Log Edit:                        Log Buffer.         (line   12)
* mode, Mail:                            Mail Methods.       (line    6)
* mode, major:                           Major Modes.        (line    6)
* mode, Menu Bar:                        Menu Bars.          (line    6)
* mode, Message:                         Mail Commands.      (line    6)
* mode, Minibuffer Electric Default:     Basic Minibuffer.   (line   23)
* mode, minor:                           Minor Modes.        (line    6)
* mode, Mouse Wheel:                     Mouse Commands.     (line  109)
* mode, MSB:                             Buffer Menus.       (line   22)
* mode, nXML:                            HTML Mode.          (line   75)
* mode, Objective C:                     C Modes.            (line    6)
* mode, Occur:                           Other Repeating Search.
                                                             (line   41)
* mode, Occur Edit:                      Other Repeating Search.
                                                             (line   71)
* mode, Org:                             Org Mode.           (line    6)
* mode, Outline:                         Outline Mode.       (line    6)
* mode, Overwrite:                       Minor Modes.        (line   83)
* mode, Paragraph-Indent Text:           Text Mode.          (line   27)
* mode, Pike:                            C Modes.            (line    6)
* mode, Scheme:                          External Lisp.      (line   35)
* mode, Scroll Bar:                      Scroll Bars.        (line    6)
* mode, Scroll-all:                      Window Convenience. (line   49)
* mode, Semantic:                        Semantic.           (line   18)
* mode, SGML:                            HTML Mode.          (line    6)
* mode, Shell:                           Shell Mode.         (line    6)
* mode, SliTeX:                          TeX Mode.           (line    6)
* mode, Tab Bar:                         Tab Bars.           (line    6)
* mode, tar:                             File Archives.      (line    6)
* mode, Term:                            Term Mode.          (line    6)
* mode, TeX:                             TeX Mode.           (line    6)
* mode, Text:                            Text Mode.          (line    6)
* mode, Thumbs:                          Image Mode.         (line   76)
* mode, Tool Bar:                        Tool Bars.          (line    6)
* mode, Transient Mark:                  Disabled Transient Mark.
                                                             (line    6)
* mode, View:                            View Mode.          (line    6)
* mode, Visual Line:                     Visual Line Mode.   (line   14)
* mode, Whitespace:                      Useless Whitespace. (line   37)
* mode, Window Divider:                  Window Dividers.    (line    6)
* mode, Winner:                          Window Convenience. (line    6)
* mode, XML:                             HTML Mode.          (line   75)
* mode-line face:                        Standard Faces.     (line   80)
* mode-line-buffer-id face:              Standard Faces.     (line   95)
* mode-line-highlight face:              Standard Faces.     (line   91)
* mode-line-inactive face:               Standard Faces.     (line   86)
* modes for editing programs:            Hooks.              (line   68)
* modes for programming languages:       Program Modes.      (line    6)
* modification dates:                    Time Stamps.        (line    6)
* modified (buffer):                     Visiting.           (line   49)
* modifier keys:                         User Input.         (line   18)
* modifier keys (macOS):                 Mac / GNUstep Basics.
                                                             (line    6)
* modifier keys, and key rebinding:      Modifier Keys.      (line    6)
* Modula2 mode:                          Program Modes.      (line   15)
* module verification:                   Initial Options.    (line  146)
* moon, phases of:                       Lunar Phases.       (line    6)
* Morse code:                            Amusements.         (line   45)
* Motif Widget X Resources:              Motif Resources.    (line    6)
* motion commands, during incremental search: Not Exiting Isearch.
                                                             (line   71)
* mouse avoidance:                       Mouse Avoidance.    (line    6)
* mouse button events:                   Mouse Buttons.      (line    6)
* mouse buttons (what they do):          Mouse Commands.     (line    6)
* mouse on mode line:                    Mode Line Mouse.    (line    6)
* mouse pointer:                         Display Custom.     (line   97)
* mouse pointer color, command-line argument: Colors X.      (line   28)
* mouse support:                         Text-Only Mouse.    (line    6)
* mouse support under MS-DOS:            MS-DOS Mouse.       (line    6)
* mouse wheel:                           Mouse Commands.     (line  109)
* Mouse Wheel minor mode:                Mouse Commands.     (line  109)
* mouse, and MS-Windows:                 Windows Mouse.      (line    6)
* mouse, dragging:                       Mouse Commands.     (line   42)
* mouse, selecting text using:           Mouse Commands.     (line    6)
* mouse, set number of buttons:          MS-DOS Mouse.       (line   18)
* move to beginning or end of function:  Moving by Defuns.   (line   17)
* movemail:                              Remote Mailboxes.   (line    6)
* movemail program:                      Movemail.           (line    6)
* movement:                              Moving Point.       (line    6)
* moving files (in Dired):               Operating on Files. (line   68)
* moving inside the calendar:            Calendar Motion.    (line    6)
* moving point:                          Moving Point.       (line    6)
* moving text:                           Yanking.            (line    6)
* moving the cursor:                     Moving Point.       (line    6)
* MS-DOS end-of-line conversion:         Coding Systems.     (line   56)
* MS-DOS peculiarities:                  MS-DOS.             (line    6)
* MS-Windows codepages:                  MS-DOS and MULE.    (line   87)
* MS-Windows keyboard shortcuts:         Windows Keyboard.   (line    9)
* MS-Windows, and primary selection:     Primary Selection.  (line   30)
* MS-Windows, Emacs peculiarities:       Microsoft Windows.  (line    6)
* MSB mode:                              Buffer Menus.       (line   22)
* MULE:                                  Glossary.           (line  973)
* multibyte characters:                  International.      (line    6)
* multiple displays:                     Multiple Displays.  (line    6)
* multiple source file search and replace: Identifier Search.
                                                             (line    6)
* multiple views of outline:             Outline Views.      (line    6)
* multiple windows in Emacs:             Windows.            (line    6)
* multiple-buffer isearch:               Other Repeating Search.
                                                             (line   13)
* multiple-file isearch:                 Other Repeating Search.
                                                             (line   25)
* Multipurpose Internet Mail Extensions: Mail Misc.          (line    6)
* Multithreaded debugging in GDB:        Multithreaded Debugging.
                                                             (line    6)
* names of backup files:                 Backup Names.       (line    6)
* narrowing:                             Narrowing.          (line    6)
* narrowing, and line number display:    Optional Mode Line. (line   36)
* net use, and printing on MS-Windows:   Windows Printing.   (line   38)
* network security manager:              Network Security.   (line    6)
* networked printers (MS-Windows):       Windows Printing.   (line   38)
* newline:                               Inserting Text.     (line   11)
* newlines, hard and soft:               Hard and Soft Newlines.
                                                             (line    6)
* newsreader:                            Gnus.               (line    6)
* Next Error Follow mode:                Compilation Mode.   (line  130)
* NFS and quitting:                      Quitting.           (line   56)
* nil:                                   Glossary.           (line 1004)
* no-conversion, coding system:          Coding Systems.     (line  100)
* nobreak-space face:                    Text Display.       (line   35)
* non-ASCII characters in .emacs:        Init Non-ASCII.     (line    6)
* non-ASCII keys, binding:               Init Non-ASCII.     (line    6)
* non-breaking hyphen:                   Text Display.       (line   35)
* non-breaking space:                    Text Display.       (line   35)
* non-greedy regexp matching:            Regexps.            (line   73)
* non-integral number of lines in a window: Optional Mode Line.
                                                             (line   86)
* non-selected windows, mode line appearance: Optional Mode Line.
                                                             (line   91)
* Non-stop debugging in GDB:             Multithreaded Debugging.
                                                             (line    6)
* non-strict locking (RCS):              RCS and SCCS.       (line    6)
* nonincremental search:                 Nonincremental Search.
                                                             (line    6)
* normal hook:                           Hooks.              (line   13)
* nroff:                                 Nroff Mode.         (line    6)
* NSA:                                   Mail Amusements.    (line    6)
* NSM:                                   Network Security.   (line    6)
* number lines in a buffer:              Display Custom.     (line    9)
* numeric arguments:                     Arguments.          (line    6)
* nXML mode:                             HTML Mode.          (line   75)
* Objective C mode:                      C Modes.            (line    6)
* obsolete command:                      M-x.                (line   37)
* Occur Edit mode:                       Other Repeating Search.
                                                             (line   71)
* Occur mode:                            Other Repeating Search.
                                                             (line   41)
* octal escapes:                         Text Display.       (line   26)
* Octave mode:                           Program Modes.      (line   15)
* omer count:                            Sexp Diary Entries. (line  162)
* OPascal mode:                          Program Modes.      (line   15)
* open file:                             Visiting.           (line    6)
* open-parenthesis in leftmost column:   Left Margin Paren.  (line    6)
* OpenDocument file:                     Document View.      (line    6)
* operating on files in Dired:           Operating on Files. (line    6)
* operations on a marked region:         Using Region.       (line    6)
* options (command line):                Emacs Invocation.   (line    6)
* Org agenda:                            Org Organizer.      (line    6)
* Org exporting:                         Org Authoring.      (line    6)
* Org mode:                              Org Mode.           (line    6)
* organizer:                             Org Mode.           (line    6)
* Oriya:                                 Language Environments.
                                                             (line   35)
* out of memory:                         Memory Full.        (line    6)
* outer border width, command-line argument: Borders X.      (line   20)
* Outline mode:                          Outline Mode.       (line    6)
* outline with multiple views:           Outline Views.      (line    6)
* overlays at character position:        Editing Format Info.
                                                             (line   20)
* override character terminal color support: Colors X.       (line   35)
* overscrolling:                         Scroll Bars.        (line   40)
* overwrapped search:                    Repeat Isearch.     (line   40)
* Overwrite mode:                        Minor Modes.        (line   83)
* Package:                               Packages.           (line    6)
* Package archive:                       Packages.           (line    6)
* package directory:                     Package Files.      (line    6)
* package file:                          Package Files.      (line    6)
* package menu:                          Package Menu.       (line    6)
* package requirements:                  Package Installation.
                                                             (line   11)
* package security:                      Package Installation.
                                                             (line   28)
* package signing:                       Package Installation.
                                                             (line   28)
* package status:                        Package Statuses.   (line    6)
* pages:                                 Pages.              (line    6)
* paging in Term mode:                   Term Mode.          (line   26)
* paragraph, base direction:             Bidirectional Editing.
                                                             (line   37)
* Paragraph-Indent Text mode:            Text Mode.          (line   27)
* paragraphs:                            Paragraphs.         (line    6)
* parasha, weekly:                       Sexp Diary Entries. (line  162)
* parentheses, displaying matches:       Matching.           (line    6)
* parentheses, moving across:            Moving by Parens.   (line    6)
* parenthesis in column zero and fontification: Font Lock.   (line   54)
* parenthetical groupings:               Moving by Parens.   (line    6)
* partial completion:                    Completion Styles.  (line   30)
* partial-completion, completion style:  Completion Styles.  (line   30)
* paste:                                 Cut and Paste.      (line    6)
* pasting:                               Yanking.            (line    6)
* patches, applying:                     Diff Mode.          (line   74)
* patches, editing:                      Diff Mode.          (line    6)
* patches, sending:                      Sending Patches.    (line    6)
* PCL-CVS:                               VC Directory Mode.  (line   24)
* PDB:                                   Debuggers.          (line    6)
* PDF file:                              Document View.      (line    6)
* per-buffer variables:                  Locals.             (line   27)
* per-connection local variables:        Connection Variables.
                                                             (line    6)
* per-directory local variables:         Directory Variables.
                                                             (line    6)
* Perl mode:                             Program Modes.      (line   15)
* Perldb:                                Debuggers.          (line    6)
* Persian:                               Language Environments.
                                                             (line   35)
* Persian calendar:                      Calendar Systems.   (line   47)
* phases of the moon:                    Lunar Phases.       (line    6)
* phrase, highlighting:                  Highlight Interactively.
                                                             (line   65)
* Picture mode and rectangles:           Rectangles in Picture.
                                                             (line    6)
* pictures:                              Picture Mode.       (line    6)
* Pike mode:                             C Modes.            (line    6)
* pinning Emacs to Windows task bar:     Windows Startup.    (line   20)
* planner:                               Org Mode.           (line    6)
* point:                                 Point.              (line    6)
* point location:                        Position Info.      (line   37)
* point location, on MS-DOS:             Text and Binary.    (line   20)
* Polish:                                Language Environments.
                                                             (line   35)
* Pong game:                             Amusements.         (line   50)
* POP3 mailboxes:                        Remote Mailboxes.   (line   14)
* position and size of Emacs frame:      Window Size X.      (line    6)
* PostScript file:                       Document View.      (line    6)
* PostScript mode:                       Program Modes.      (line   15)
* prefix argument commands, during incremental search: Not Exiting Isearch.
                                                             (line   23)
* prefix arguments:                      Arguments.          (line    6)
* prefix key:                            Keys.               (line   10)
* preprocessor highlighting:             Other C Commands.   (line   56)
* pretty-printer:                        Program Indent.     (line   23)
* prevent commands from exiting incremental search: Not Exiting Isearch.
                                                             (line   57)
* preview of registers:                  Registers.          (line   28)
* primary Rmail file:                    Rmail Basics.       (line    6)
* primary selection:                     Primary Selection.  (line    6)
* primary selection, when active region changes: Setting Mark.
                                                             (line   76)
* printing:                              Printing.           (line    6)
* printing character:                    Text Display.       (line    6)
* printing files (in Dired):             Operating on Files. (line  119)
* Printing package:                      Printing Package.   (line    6)
* printing under MS-DOS:                 MS-DOS Processes.   (line   29)
* Prog mode:                             Hooks.              (line   68)
* program building:                      Building.           (line    6)
* program editing:                       Programs.           (line    6)
* project back-end:                      Projects.           (line   11)
* project root:                          Projects.           (line    6)
* projects:                              Projects.           (line    6)
* Prolog mode:                           Program Modes.      (line   15)
* prompt:                                Basic Minibuffer.   (line    6)
* prompt, shell:                         Shell Prompts.      (line    6)
* PS file:                               Document View.      (line    6)
* Punjabi:                               Language Environments.
                                                             (line   36)
* puzzles:                               Amusements.         (line    9)
* Python mode:                           Program Modes.      (line   15)
* query replace:                         Query Replace.      (line    6)
* query-replace face:                    Query Replace.      (line   34)
* quitting:                              Quitting.           (line   28)
* quitting (in search):                  Error in Isearch.   (line   23)
* quitting Emacs:                        Exiting.            (line    6)
* quitting on MS-DOS:                    MS-DOS Keyboard.    (line   12)
* Quotation marks:                       Quotation Marks.    (line    6)
* quoting:                               Inserting Text.     (line   30)
* quoting file names:                    Quoted File Names.  (line    6)
* rar:                                   File Archives.      (line   45)
* raw bytes:                             International Chars.
                                                             (line   54)
* raw-text, coding system:               Coding Systems.     (line   91)
* RCS:                                   Version Control Systems.
                                                             (line   20)
* read-only buffer:                      Misc Buffer.        (line   15)
* read-only text, killing:               Kill Options.       (line    6)
* reading mail:                          Rmail.              (line    6)
* rebinding keys, permanently:           Init Rebinding.     (line    6)
* rebinding keys, this session:          Rebinding.          (line    6)
* rebinding major mode keys:             Init Rebinding.     (line    6)
* rebinding mouse buttons:               Mouse Buttons.      (line    6)
* rebinding non-ASCII keys:              Init Non-ASCII.     (line    6)
* recovering crashed session:            After a Crash.      (line    6)
* rectangle:                             Rectangles.         (line    6)
* rectangle highlighting:                CUA Bindings.       (line   30)
* rectangles and Picture mode:           Rectangles in Picture.
                                                             (line    6)
* rectangular region:                    Rectangles.         (line   13)
* recursive copying:                     Operating on Files. (line   56)
* recursive deletion:                    Dired Deletion.     (line   51)
* recursive editing level:               Recursive Edit.     (line    6)
* recursive editing, cannot exit:        Stuck Recursive.    (line    6)
* recycle bin:                           Misc File Ops.      (line   13)
* redo:                                  Undo.               (line   28)
* refreshing displayed files:            Dired Updating.     (line    6)
* regexp:                                Regexps.            (line    6)
* regexp search:                         Regexp Search.      (line    6)
* region:                                Mark.               (line    6)
* region highlighting:                   Disabled Transient Mark.
                                                             (line    6)
* region-rectangle:                      Rectangles.         (line   13)
* registered file:                       VCS Concepts.       (line    6)
* registers:                             Registers.          (line    6)
* registry, setting environment variables (MS-Windows): MS-Windows Registry.
                                                             (line    6)
* registry, setting resources (MS-Windows): Resources.       (line   18)
* regular expression:                    Regexps.            (line    6)
* related files:                         Other C Commands.   (line   94)
* reload files:                          Saving Emacs Sessions.
                                                             (line    6)
* remember editing session:              Saving Emacs Sessions.
                                                             (line    6)
* remote file access:                    Remote Files.       (line    6)
* remote host:                           Remote Host.        (line    6)
* remote host, debugging on:             Starting GUD.       (line   52)
* remote repositories (CVS):             CVS Options.        (line   11)
* remove indentation:                    Indentation Commands.
                                                             (line   57)
* renaming files:                        Copying and Naming. (line   29)
* renaming files (in Dired):             Operating on Files. (line   68)
* renaming version-controlled files:     VC Delete/Rename.   (line    6)
* repeating a command:                   Repeating.          (line    6)
* replacement:                           Replace.            (line    6)
* reply to a message:                    Rmail Reply.        (line   28)
* report an Emacs bug, how to:           Understanding Bug Reporting.
                                                             (line    6)
* repository:                            VCS Concepts.       (line    6)
* reread a file:                         Reverting.          (line    6)
* reserved key bindings:                 Key Bindings.       (line   11)
* resize window:                         Change Window.      (line   49)
* resizing minibuffer:                   Minibuffer Edit.    (line   26)
* resizing windows:                      Change Window.      (line   49)
* resolving conflicts:                   Merging.            (line   34)
* resource files for GTK+:               GTK resources.      (line    6)
* resource name, command-line argument:  Resources.          (line   63)
* resource values, command-line argument: Resources.         (line   80)
* resources:                             Resources.          (line    6)
* restore session:                       Saving Emacs Sessions.
                                                             (line    6)
* restriction:                           Narrowing.          (line    6)
* retrying a failed message:             Rmail Reply.        (line   57)
* reverse order in POP3 inboxes:         Remote Mailboxes.   (line   60)
* reverse video, command-line argument:  Colors X.           (line   33)
* revision:                              VCS Concepts.       (line   21)
* revision ID:                           VCS Concepts.       (line   21)
* revision ID in version control:        Advanced C-x v v.   (line    6)
* revision tag:                          Revision Tags.      (line    6)
* RGB triplet:                           Colors.             (line   29)
* right-to-left text:                    Bidirectional Editing.
                                                             (line    6)
* risky variable:                        Safe File Variables.
                                                             (line   27)
* RLM:                                   Bidirectional Editing.
                                                             (line   60)
* Rlogin:                                Remote Host.        (line    6)
* Rmail:                                 Rmail.              (line    6)
* Rmail file sorting:                    Rmail Sorting.      (line    6)
* Romanian:                              Language Environments.
                                                             (line   36)
* rosh hodesh:                           Sexp Diary Entries. (line  162)
* rot13 code:                            Rmail Rot13.        (line    6)
* Ruby mode:                             Program Modes.      (line   15)
* runemacs.exe:                          Windows Startup.    (line    8)
* running a hook:                        Hooks.              (line    6)
* running Lisp functions:                Building.           (line    6)
* Russian:                               Language Environments.
                                                             (line   36)
* s-:                                    Modifier Keys.      (line   26)
* saved echo area messages:              Echo Area.          (line   34)
* saving a setting:                      Changing a Variable.
                                                             (line   92)
* saving file name in a register:        File Registers.     (line    6)
* saving files:                          Visiting.           (line   23)
* saving keyboard macro in a register:   Keyboard Macro Registers.
                                                             (line    6)
* saving keyboard macros:                Save Keyboard Macro.
                                                             (line   15)
* saving number in a register:           Number Registers.   (line    6)
* saving position in a register:         Position Registers. (line    6)
* saving rectangle in a register:        Rectangle Registers.
                                                             (line    6)
* saving sessions:                       Saving Emacs Sessions.
                                                             (line    6)
* saving text in a register:             Text Registers.     (line    6)
* saving window configuration in a register: Configuration Registers.
                                                             (line    6)
* SCCS:                                  Version Control Systems.
                                                             (line    9)
* Scheme mode:                           External Lisp.      (line   35)
* screen:                                Screen.             (line    6)
* screen display, wrong:                 Screen Garbled.     (line    6)
* screen reader software, MS-Windows:    Windows Misc.       (line    9)
* script mode:                           Initial Options.    (line   69)
* script of a character:                 Modifying Fontsets. (line   39)
* scroll bar (X resource):               Table of Resources. (line  122)
* Scroll Bar mode:                       Scroll Bars.        (line    6)
* Scroll-all mode:                       Window Convenience. (line   49)
* scroll-bar face:                       Scroll Bars.        (line   49)
* scroll-command property:               Scrolling.          (line   59)
* scrollbar width (X resource):          Table of Resources. (line  126)
* scrolling:                             Scrolling.          (line    6)
* scrolling commands, during incremental search: Not Exiting Isearch.
                                                             (line   39)
* scrolling in the calendar:             Scroll Calendar.    (line    6)
* scrolling windows together:            Window Convenience. (line   49)
* SDB:                                   Debuggers.          (line    6)
* search and replace in multiple files (in Dired): Operating on Files.
                                                             (line  184)
* search and replace in multiple source files: Identifier Search.
                                                             (line    6)
* search customizations:                 Search Customizations.
                                                             (line    6)
* search display on slow terminals:      Search Customizations.
                                                             (line   64)
* search for a regular expression:       Regexp Search.      (line    6)
* search Internet for keywords:          Word Search.        (line   55)
* search mode, default:                  Search Customizations.
                                                             (line    9)
* search multiple files (in Dired):      Operating on Files. (line  169)
* search ring:                           Repeat Isearch.     (line   48)
* search, overwrapped:                   Repeat Isearch.     (line   40)
* search, wrapping around:               Repeat Isearch.     (line   40)
* search-and-replace commands:           Replace.            (line    6)
* searching:                             Search.             (line    6)
* searching Dired buffers:               Dired Navigation.   (line   20)
* searching documentation efficiently:   Help.               (line   17)
* searching in Rmail:                    Rmail Motion.       (line   60)
* searching multiple files via Dired:    Misc Dired Features.
                                                             (line   13)
* secondary selection:                   Secondary Selection.
                                                             (line    6)
* secondary-selection face:              Secondary Selection.
                                                             (line   11)
* sections of manual pages:              Man Page.           (line   22)
* security:                              Host Security.      (line    6)
* security, when displaying enriched text: Enriched Properties.
                                                             (line   16)
* select all:                            Marking Objects.    (line   52)
* selected buffer:                       Buffers.            (line   27)
* selected window:                       Basic Window.       (line   12)
* selecting buffers in other windows:    Pop Up Window.      (line    6)
* selection, primary:                    Primary Selection.  (line    6)
* selective display:                     Selective Display.  (line    6)
* selective undo:                        Undo.               (line   53)
* self-documentation:                    Help.               (line    6)
* Semantic mode:                         Semantic.           (line   18)
* Semantic package:                      Semantic.           (line    6)
* sending mail:                          Sending Mail.       (line    6)
* sending patches for GNU Emacs:         Sending Patches.    (line    6)
* Sendmail:                              Mail Sending.       (line   28)
* sentences:                             Sentences.          (line    6)
* server file:                           TCP Emacs server.   (line   32)
* server, using Emacs as:                Emacs Server.       (line    6)
* server-side fonts:                     Fonts.              (line  197)
* set buffer face height:                Text Scale.         (line   29)
* sets of files:                         Filesets.           (line    6)
* setting a mark:                        Mark.               (line    6)
* setting variables:                     Examining.          (line    6)
* settings:                              Easy Customization. (line    6)
* settings, how to save:                 Changing a Variable.
                                                             (line   92)
* sexp:                                  Expressions.        (line    6)
* sexp diary entries:                    Sexp Diary Entries. (line    6)
* SGML mode:                             HTML Mode.          (line    6)
* shadow cluster:                        File Shadowing.     (line   17)
* shadow face:                           Standard Faces.     (line   28)
* shadow files:                          File Shadowing.     (line    6)
* shell commands:                        Shell.              (line    6)
* shell commands, Dired:                 Shell Commands in Dired.
                                                             (line    6)
* shell completion:                      Shell Mode.         (line   20)
* SHELL environment variable:            Interactive Shell.  (line   36)
* Shell mode:                            Shell Mode.         (line    6)
* shell scripts, and local file variables: Specifying File Variables.
                                                             (line   35)
* Shell-script mode:                     Program Modes.      (line   15)
* shelves in version control:            VC Directory Commands.
                                                             (line  132)
* shift-selection:                       Shift Selection.    (line    6)
* Show Paren mode:                       Matching.           (line   34)
* showing hidden subdirectories (Dired): Hiding Subdirectories.
                                                             (line    6)
* shy group, in regexp:                  Regexp Backslash.   (line   47)
* signing files (in Dired):              Operating on Files. (line  152)
* Simula mode:                           Program Modes.      (line   15)
* simulation of middle mouse button:     Windows Mouse.      (line    9)
* simultaneous editing:                  Interlocking.       (line    6)
* Sinhala:                               Language Environments.
                                                             (line   36)
* site init file:                        Init File.          (line   29)
* site-lisp directories:                 Init File.          (line   38)
* site-lisp files, not loading:          Initial Options.    (line  100)
* site-start.el file, not loading:       Initial Options.    (line   96)
* site-start.el, the site startup file:  Init File.          (line   29)
* size of file, warning when visiting:   Visiting.           (line   62)
* size of minibuffer:                    Minibuffer Edit.    (line   26)
* skeletons:                             Text.               (line   35)
* slashes repeated in file name:         Minibuffer File.    (line   34)
* SliTeX mode:                           TeX Mode.           (line    6)
* Slovak:                                Language Environments.
                                                             (line   36)
* Slovenian:                             Language Environments.
                                                             (line   36)
* Smerge mode:                           Comparing Files.    (line   54)
* SMTP:                                  Mail Sending.       (line   28)
* Snake:                                 Amusements.         (line   50)
* so-long mode:                          Long Lines.         (line   13)
* socket activation, systemd, Emacs:     Emacs Server.       (line   40)
* soft hyphen:                           Text Display.       (line   35)
* soft newline:                          Hard and Soft Newlines.
                                                             (line    6)
* solitaire:                             Amusements.         (line   53)
* sorting:                               Sorting.            (line    6)
* sorting diary entries:                 Fancy Diary Display.
                                                             (line    8)
* sorting Dired buffer:                  Dired Updating.     (line   67)
* sorting Rmail file:                    Rmail Sorting.      (line    6)
* Spanish:                               Language Environments.
                                                             (line   36)
* specific version control system:       Advanced C-x v v.   (line   10)
* specify default font from the command line: Font X.        (line   11)
* specify dump file:                     Initial Options.    (line  154)
* specify end-of-line conversion:        Text Coding.        (line   37)
* specifying fullscreen for Emacs frame: Window Size X.      (line    6)
* speedbar:                              Speedbar.           (line    6)
* spell-checking the active region:      Spelling.           (line   47)
* spelling, checking and correcting:     Spelling.           (line    6)
* splash screen:                         Initial Options.    (line  104)
* splitting columns:                     Two-Column.         (line    6)
* splitting table cells:                 Cell Commands.      (line   17)
* SRC:                                   Version Control Systems.
                                                             (line   51)
* src:                                   Version Control Systems.
                                                             (line   51)
* SSL:                                   Network Security.   (line    6)
* standard colors on a character terminal: Colors X.         (line   35)
* standard faces:                        Standard Faces.     (line    6)
* standard fontset:                      Defining Fontsets.  (line    6)
* start directory, MS-Windows:           Windows Startup.    (line    8)
* start iconified, command-line argument: Icons X.           (line    8)
* starting Emacs:                        Entering Emacs.     (line    6)
* starting Emacs on MS-Windows:          Windows Startup.    (line    6)
* STARTTLS:                              Network Security.   (line    6)
* startup (command line arguments):      Emacs Invocation.   (line    6)
* startup (init file):                   Init File.          (line    6)
* startup fontset:                       Defining Fontsets.  (line   22)
* startup message:                       Initial Options.    (line  104)
* startup screen:                        Entering Emacs.     (line   13)
* stashes in version control:            VC Directory Commands.
                                                             (line  132)
* string substitution:                   Replace.            (line    6)
* string syntax:                         Init Syntax.        (line   30)
* stuck in recursive editing:            Stuck Recursive.    (line    6)
* style (for indentation):               Custom C Indent.    (line    6)
* subdirectories in Dired:               Subdirectories in Dired.
                                                             (line    6)
* subprocesses on MS-Windows:            Windows Processes.  (line    6)
* subscribe groups:                      Gnus Group Buffer.  (line   29)
* subshell:                              Shell.              (line    6)
* substring, completion style:           Completion Styles.  (line   49)
* subtree (Outline mode):                Outline Visibility. (line   54)
* Subversion:                            Version Control Systems.
                                                             (line   33)
* Subword mode:                          MixedCase Words.    (line   23)
* summary (Rmail):                       Rmail Summary.      (line    6)
* summing time intervals:                Time Intervals.     (line    6)
* sunrise and sunset:                    Sunrise/Sunset.     (line    6)
* Super (under MS-DOS):                  MS-DOS Keyboard.    (line   20)
* Super, modifier key:                   Modifier Keys.      (line   26)
* suspending:                            Exiting.            (line   47)
* suspicious constructions in C, C++:    Other C Commands.   (line   71)
* SVN:                                   Version Control Systems.
                                                             (line   33)
* Swedish:                               Language Environments.
                                                             (line   37)
* switch buffers:                        Select Buffer.      (line    6)
* switches (command line):               Emacs Invocation.   (line    6)
* symbol search:                         Symbol Search.      (line    6)
* symbol, highlighting:                  Highlight Interactively.
                                                             (line   72)
* symbolic links (and version control):  General VC Options. (line   11)
* symbolic links (creation in Dired):    Operating on Files. (line   90)
* symbolic links (creation):             Copying and Naming. (line   47)
* symbolic links (visiting):             File Aliases.       (line    6)
* synchronizing windows:                 Follow Mode.        (line    6)
* synchronous X mode:                    Table of Resources. (line  146)
* syntax highlighting and coloring:      Font Lock.          (line    6)
* syntax of regexps:                     Regexps.            (line    6)
* system-wide packages:                  Package Files.      (line   21)
* systemd unit file:                     Emacs Server.       (line   32)
* t:                                     Glossary.           (line 1004)
* tab bar (X resource):                  Table of Resources. (line  157)
* tab bar mode:                          Tab Bars.           (line    6)
* tab line:                              Tab Line.           (line    6)
* tab stops:                             Tab Stops.          (line    6)
* tab-line face:                         Standard Faces.     (line  107)
* table creation:                        Table Creation.     (line    6)
* table dimensions:                      Table Misc.         (line    6)
* table for HTML and LaTeX:              Table Misc.         (line   24)
* table mode:                            Text Based Tables.  (line    6)
* table recognition:                     Table Recognition.  (line    6)
* table to text:                         Table Conversion.   (line    6)
* tabs:                                  Indentation.        (line    6)
* tabs, tabbar:                          Tab Bars.           (line    6)
* tags and tag tables:                   Tags Tables.        (line    6)
* tags for version control:              Revision Tags.      (line    6)
* tags, C++:                             Tags Tables.        (line   26)
* tags-based completion:                 Symbol Completion.  (line   14)
* TaiViet:                               Language Environments.
                                                             (line   37)
* Tajik:                                 Language Environments.
                                                             (line   37)
* Tamil:                                 Language Environments.
                                                             (line   37)
* Tar mode:                              File Archives.      (line    6)
* Tcl mode:                              Program Modes.      (line   15)
* TCP Emacs server:                      TCP Emacs server.   (line    6)
* Telnet:                                Remote Host.        (line    6)
* Telugu:                                Language Environments.
                                                             (line   37)
* templates:                             Text.               (line   35)
* temporary windows:                     Temporary Displays. (line    6)
* Term mode:                             Term Mode.          (line    6)
* terminal emulators, mouse support:     Text-Only Mouse.    (line    6)
* terminal, serial:                      Serial Terminal.    (line    6)
* termscript file:                       Checklist.          (line  115)
* Tetris:                                Amusements.         (line   50)
* TeX encoding:                          TeX Misc.           (line   12)
* TeX mode:                              TeX Mode.           (line    6)
* TEXEDIT environment variable:          Emacs Server.       (line   61)
* TEXINPUTS environment variable:        TeX Print.          (line   46)
* text:                                  Text.               (line    6)
* text and binary files on MS-DOS/MS-Windows: Text and Binary.
                                                             (line    6)
* text buttons:                          Mouse References.   (line    6)
* text colors, from command line:        Colors X.           (line    6)
* text cursor:                           Cursor Display.     (line    6)
* Text mode:                             Text Mode.          (line    6)
* text properties at point:              International Chars.
                                                             (line   65)
* text properties of characters:         Editing Format Info.
                                                             (line   20)
* text terminal:                         Non-Window Terminals.
                                                             (line    6)
* text to table:                         Table Conversion.   (line    6)
* text-based tables:                     Text Based Tables.  (line    6)
* text-based tables, splitting cells:    Cell Commands.      (line   17)
* text/enriched MIME format:             Enriched Text.      (line    6)
* Thai:                                  Language Environments.
                                                             (line   37)
* Tibetan:                               Language Environments.
                                                             (line   37)
* tilde (~) at end of backup file name:  Backup Names.       (line    6)
* time (on mode line):                   Optional Mode Line. (line   53)
* time intervals, summing:               Time Intervals.     (line    6)
* time stamps:                           Time Stamps.        (line    6)
* timeclock:                             Time Intervals.     (line    6)
* timelog file:                          Time Intervals.     (line   34)
* TLS:                                   Network Security.   (line    6)
* TLS encryption (Rmail):                Remote Mailboxes.   (line   65)
* TODO item:                             Org Organizer.      (line    6)
* toggling marks (in Dired):             Marks vs Flags.     (line   92)
* tool bar (X resource):                 Table of Resources. (line  153)
* tool bar mode:                         Tool Bars.          (line    6)
* Tool Bar position:                     Tool Bars.          (line   25)
* Tool Bar style:                        Tool Bars.          (line   19)
* tooltip help:                          Help Echo.          (line    6)
* tooltips:                              Tooltips.           (line    6)
* top level:                             Mode Line.          (line    6)
* tower of Hanoi:                        Amusements.         (line   39)
* trailing whitespace:                   Useless Whitespace. (line    6)
* trailing whitespace, in patches:       Diff Mode.          (line  157)
* trailing-whitespace face:              Useless Whitespace. (line   10)
* Tramp:                                 Remote Files.       (line    6)
* Transient Mark mode:                   Disabled Transient Mark.
                                                             (line    6)
* Transport Layer Security:              Network Security.   (line    6)
* transposition of expressions:          Expressions.        (line   47)
* trash:                                 Misc File Ops.      (line   13)
* triple clicks:                         Mouse Buttons.      (line   28)
* troubleshooting Emacs:                 Lossage.            (line    6)
* truenames of files:                    File Aliases.       (line   27)
* truncation:                            Line Truncation.    (line    6)
* TTY menu faces:                        Standard Faces.     (line  152)
* Turkish:                               Language Environments.
                                                             (line   37)
* two directories (in Dired):            Operating on Files. (line   25)
* two-column editing:                    Two-Column.         (line    6)
* types of log file:                     Types of Log File.  (line    6)
* typos, fixing:                         Fixit.              (line    6)
* Ukrainian:                             Language Environments.
                                                             (line   38)
* unbalanced parentheses and quotes:     Parentheses.        (line    6)
* uncompression:                         Compressed Files.   (line    6)
* undecided, coding system:              Coding Systems.     (line   86)
* undeletion (Rmail):                    Rmail Deletion.     (line   41)
* undigestify:                           Rmail Digest.       (line    6)
* undisplayable characters:              International Chars.
                                                             (line   18)
* undo:                                  Undo.               (line    6)
* undo limit:                            Undo.               (line   66)
* undoing window configuration changes:  Window Convenience. (line    6)
* Unibyte operation:                     Unibyte Mode.       (line    6)
* Unicode:                               International Chars.
                                                             (line   11)
* Unicode characters, inserting:         Inserting Text.     (line   60)
* Unicode Collation Algorithm (UCA), and ls-lisp.el: ls in Lisp.
                                                             (line   36)
* unique buffer names:                   Uniquify.           (line    6)
* unmarking files (in Dired):            Marks vs Flags.     (line   56)
* unsaved buffers, killing:              Kill Buffer.        (line   22)
* unsaved customizations, reminder to save: Saving Customizations.
                                                             (line   46)
* unsubscribe groups:                    Gnus Group Buffer.  (line   29)
* untranslated file system:              Text and Binary.    (line   51)
* unused lines:                          Useless Whitespace. (line   28)
* unzip archives:                        File Archives.      (line   45)
* upcase file names:                     Transforming File Names.
                                                             (line   21)
* updating Dired buffer:                 Dired Updating.     (line    6)
* URL, viewing in help:                  Help Mode.          (line   38)
* URLs:                                  Browse-URL.         (line    6)
* URLs, activating:                      Goto Address mode.  (line    6)
* Usenet news:                           Gnus.               (line    6)
* user name for remote file access:      Remote Files.       (line   35)
* user option:                           Easy Customization. (line    6)
* user options, changing:                Changing a Variable.
                                                             (line   35)
* using Nextstep services (macOS):       Mac / GNUstep Events.
                                                             (line   73)
* UTF-8:                                 Language Environments.
                                                             (line   38)
* variable:                              Variables.          (line    6)
* variable-pitch face:                   Standard Faces.     (line   26)
* variables, changing:                   Changing a Variable.
                                                             (line   35)
* VC:                                    Version Control.    (line   10)
* VC change log:                         VC Change Log.      (line    6)
* VC Directory buffer:                   VC Directory Mode.  (line    6)
* VC filesets:                           Basic VC Editing.   (line    6)
* VC log buffer, commands in:            VC Change Log.      (line   73)
* VC mode line indicator:                VC Mode Line.       (line    6)
* vc-log buffer:                         VC Change Log.      (line   73)
* verifying digital signatures on files (in Dired): Operating on Files.
                                                             (line  148)
* Verilog mode:                          Program Modes.      (line   15)
* version control:                       Version Control.    (line    6)
* version control log:                   Types of Log File.  (line    6)
* version control status:                VC Mode Line.       (line   10)
* VERSION_CONTROL environment variable:  Backup Names.       (line   40)
* vertical border:                       Scroll Bars.        (line   54)
* Vertical Scroll Bar:                   Scroll Bars.        (line    6)
* vertical scroll bars, command-line argument: Misc X.       (line   13)
* vertical-border face:                  Standard Faces.     (line  111)
* VHDL mode:                             Program Modes.      (line   15)
* Vietnamese:                            Language Environments.
                                                             (line   38)
* View mode:                             View Mode.          (line    6)
* viewing web pages in help:             Help Mode.          (line   38)
* views of an outline:                   Outline Views.      (line    6)
* visiting files:                        Visiting.           (line    6)
* visiting files, command-line argument: Action Arguments.   (line   12)
* Visual Line mode:                      Visual Line Mode.   (line   14)
* visual order:                          Bidirectional Editing.
                                                             (line   19)
* Watching expressions in GDB:           Watch Expressions.  (line    6)
* wdired mode:                           Wdired.             (line    6)
* Web:                                   Browse-URL.         (line    6)
* web pages, viewing in help:            Help Mode.          (line   38)
* webkit widgets:                        Embedded WebKit Widgets.
                                                             (line    6)
* weeks, which day they start on:        Move to Beginning or End.
                                                             (line   27)
* Welsh:                                 Language Environments.
                                                             (line   38)
* what constitutes an Emacs bug:         Bug Criteria.       (line    6)
* whitespace character:                  Indentation.        (line    6)
* Whitespace mode:                       Useless Whitespace. (line   37)
* whitespace, trailing:                  Useless Whitespace. (line    6)
* wide block cursor:                     Cursor Display.     (line   42)
* widening:                              Narrowing.          (line    6)
* widgets at buffer position:            Editing Format Info.
                                                             (line   20)
* width and height of Emacs frame:       Window Size X.      (line    6)
* width of the vertical scroll bar:      Scroll Bars.        (line   35)
* wildcard characters in file names:     Visiting.           (line   74)
* Windmove package:                      Window Convenience. (line   26)
* window configuration changes, undoing: Window Convenience. (line    6)
* Window Divider mode:                   Window Dividers.    (line    6)
* window manager, keys stolen by:        User Input.         (line   38)
* Windows clipboard support:             MS-DOS Mouse.       (line   29)
* windows in Emacs:                      Windows.            (line    6)
* Windows system menu:                   Windows Keyboard.   (line  109)
* windows, synchronizing:                Follow Mode.        (line    6)
* Windows-1255:                          Language Environments.
                                                             (line   38)
* Winner mode:                           Window Convenience. (line    6)
* word processing:                       Enriched Text.      (line    6)
* word search:                           Word Search.        (line    6)
* word wrap:                             Visual Line Mode.   (line    6)
* words:                                 Words.              (line    6)
* words, case conversion:                Case.               (line   20)
* work file:                             VCS Concepts.       (line   13)
* working tree:                          VCS Concepts.       (line   19)
* World Wide Web:                        Browse-URL.         (line    6)
* wrapped search:                        Repeat Isearch.     (line   40)
* wrapping:                              Continuation Lines. (line    6)
* WYSIWYG:                               Enriched Text.      (line    6)
* X cutting and pasting:                 Primary Selection.  (line    6)
* X defaults file:                       Fonts.              (line   27)
* X input methods (X resource):          Table of Resources. (line  161)
* X Logical Font Description:            Fonts.              (line  121)
* X resources:                           Resources.          (line    6)
* X resources file:                      Fonts.              (line   27)
* X resources, not loading:              Initial Options.    (line  109)
* X selection:                           Primary Selection.  (line    6)
* XDB:                                   Debuggers.          (line    6)
* XDG_CONFIG_HOME:                       Init File.          (line    6)
* XIM (X resource):                      Table of Resources. (line  161)
* XLFD:                                  Fonts.              (line  121)
* XML schema:                            HTML Mode.          (line   75)
* xref:                                  Xref.               (line    6)
* xref backend:                          Xref.               (line   24)
* XREF mode:                             Xref Commands.      (line    6)
* xterm:                                 Text-Only Mouse.    (line    8)
* xwidget:                               Embedded WebKit Widgets.
                                                             (line    6)
* Xwidget-WebKit mode:                   Embedded WebKit Widgets.
                                                             (line    6)
* y or n prompt:                         Yes or No Prompts.  (line    9)
* yahrzeits:                             From Other Calendar.
                                                             (line   54)
* yahrzeits, and sexp diary entries:     Sexp Diary Entries. (line  162)
* yanking:                               Yanking.            (line    6)
* yanking previous kills:                Earlier Kills.      (line    6)
* yes or no prompt:                      Yes or No Prompts.  (line   18)
* zip:                                   File Archives.      (line   45)
* Zmacs mode:                            Disabled Transient Mark.
                                                             (line    6)
* zone:                                  Amusements.         (line   56)
* zoo:                                   File Archives.      (line   45)


vim:tw=78:ts=8:ft=help:norl:
vim:ft=help bt=nowrite bufhidden=delete readonly nomodifiable nobuflisted:
